Age,Blue,White,Military,Schooling,Home,All
16,45,4,1,1178,145,1373
17,113,15,20,1014,197,1359
18,331,92,70,561,296,1350
19,406,115,107,420,293,1341
20,454,149,113,341,273,1330
21,498,170,106,275,257,1306
22,559,256,90,169,212,1286
23,546,336,68,105,185,1240
24,416,284,44,65,112,921
25,267,215,24,24,61,591
26,127,88,2,13,32,262
All,3762,1724,645,4165,2063,12359
